10 24 24 24 24 24 24 24 24 24 13
20 9 9 9 9 9 9 9 9 9 20
21 9 10 25 9 19 9 22 13 9 21
9 9 21 9 9 9 9 9 21 9 9
19 9 9 9 22 16 25 9 9 9 19
20 9 9 9 9 9 9 9 9 9 20
21 9 9 9 22 14 25 9 9 9 21
9 9 19 9 9 9 9 9 19 9 9
19 9 11 25 9 21 9 22 12 9 19
20 9 9 9 9 9 9 9 9 9 20
11 24 24 24 24 24 24 24 24 24 12