10 24 24 24 24 24 24 24 24 24 24 24 24 24 13
20 9 9 9 9 9 9 9 9 9 9 9 9 9 20
20 9 19 9 19 9 10 24 13 9 22 24 13 9 20
20 9 20 9 20 9 20 9 20 9 9 9 20 9 20
20 9 15 24 17 9 20 9 20 9 19 9 21 9 20
20 9 20 9 20 9 20 9 20 9 20 9 9 9 20
21 9 21 9 21 9 21 9 21 9 11 24 25 9 21
9 9 9 9 9 9 9 9 9 9 9 9 9 9 9
19 9 19 9 22 24 24 13 9 10 25 9 19 9 19
20 9 20 9 9 9 9 20 9 20 9 9 20 9 20
20 9 20 9 22 25 9 21 9 20 9 9 20 9 20
20 9 20 9 9 9 9 9 9 20 9 9 20 9 20
20 9 11 24 24 24 24 25 9 11 25 9 21 9 20
20 9 9 9 9 9 9 9 9 9 9 9 9 9 20
11 24 24 24 24 24 24 24 24 24 24 24 24 24 12
