10 24 24 24 24 24 24 24 24 24 14 24 24 24 24 24 24 24 24 24 13
20 9 9 9 9 9 9 9 9 9 20 9 9 9 9 9 9 9 9 9 20
20 9 22 25 9 22 25 9 23 9 21 9 23 9 22 25 9 22 25 9 20
20 9 9 9 9 9 9 9 9 9 9 9 9 9 9 9 9 9 9 9 20
20 9 10 24 13 9 19 9 22 24 14 24 25 9 19 9 10 24 13 9 20
20 9 20 23 20 9 20 9 9 9 21 9 9 9 20 9 20 23 20 9 20
21 9 11 24 12 9 15 24 25 9 9 9 22 24 17 9 11 24 12 9 21
9 9 9 9 9 9 20 9 9 9 19 9 9 9 20 9 9 9 9 9 9
19 9 10 24 13 9 21 9 9 9 20 9 9 9 21 9 10 24 13 9 19
20 9 20 23 20 9 9 9 9 9 20 9 9 9 9 9 20 23 20 9 20
20 9 11 24 12 9 9 9 22 24 16 24 25 9 9 9 11 24 12 9 20
20 9 9 9 9 9 9 9 9 9 9 9 9 9 9 9 9 9 9 9 20
20 9 22 25 9 22 25 9 23 9 19 9 23 9 22 25 9 22 25 9 20
20 9 9 9 9 9 9 9 9 9 20 9 9 9 9 9 9 9 9 9 20
11 24 24 24 24 24 24 24 24 24 16 24 24 24 24 24 24 24 24 24 12