10 24 24 24 24 24 24 24 24 24 24 24 24 24 13 9 10 24 24 24 24 24 24 24 24 24 24 24 24 24 13
20 9 9 9 9 9 9 9 9 9 9 9 9 9 9 9 9 9 9 9 9 9 9 9 9 9 9 9 9 9 20
20 9 23 9 23 9 22 25 9 22 24 13 9 22 12 9 11 25 9 10 24 25 9 22 25 9 23 9 23 9 20
20 9 9 9 9 9 9 9 9 9 9 20 9 9 9 9 9 9 9 20 9 9 9 9 9 9 9 9 9 9 20
20 9 23 9 10 24 24 25 9 23 9 21 9 23 9 23 9 23 9 21 9 23 9 22 24 24 13 9 23 9 20
20 9 9 9 20 9 9 9 9 9 9 9 9 9 9 9 9 9 9 9 9 9 9 9 9 9 20 9 9 9 20
20 9 19 9 20 9 23 9 22 24 24 25 9 23 9 19 9 23 9 22 24 24 25 9 23 9 20 9 19 9 20
20 9 20 9 21 9 9 9 9 9 9 9 9 9 9 20 9 9 9 9 9 9 9 9 9 9 21 9 20 9 20
20 9 21 9 9 9 19 9 23 9 10 24 13 9 9 20 9 9 10 24 13 9 23 9 19 9 9 9 21 9 20
20 9 9 9 19 9 20 9 9 9 20 23 20 9 9 21 9 9 20 23 20 9 9 9 20 9 19 9 9 9 20
20 9 19 9 21 9 21 9 23 9 11 24 12 9 9 9 9 9 11 24 12 9 23 9 21 9 21 9 19 9 20
11 24 12 9 9 9 9 9 9 9 9 9 9 9 10 24 13 9 9 9 9 9 9 9 9 9 9 9 11 24 12
9 9 9 9 23 9 22 24 24 25 9 22 25 9 20 23 20 9 22 25 9 22 24 24 25 9 23 9 9 9 9
10 24 13 9 9 9 9 9 9 9 9 9 9 9 11 24 12 9 9 9 9 9 9 9 9 9 9 9 10 24 13
20 9 21 9 19 9 19 9 23 9 10 24 13 9 9 9 9 9 10 24 13 9 23 9 19 9 19 9 21 9 20
20 9 9 9 21 9 20 9 9 9 20 23 20 9 9 19 9 9 20 23 20 9 9 9 20 9 21 9 9 9 20
20 9 19 9 9 9 21 9 23 9 11 24 12 9 9 20 9 9 11 24 12 9 23 9 21 9 9 9 19 9 20
20 9 20 9 19 9 9 9 9 9 9 9 9 9 9 20 9 9 9 9 9 9 9 9 9 9 19 9 20 9 20
20 9 21 9 20 9 23 9 22 24 24 25 9 23 9 21 9 23 9 22 24 24 25 9 23 9 20 9 21 9 20
20 9 9 9 20 9 9 9 9 9 9 9 9 9 9 9 9 9 9 9 9 9 9 9 9 9 20 9 9 9 20
20 9 23 9 11 24 24 25 9 23 9 19 9 23 9 23 9 23 9 19 9 23 9 22 24 24 12 9 23 9 20
20 9 9 9 9 9 9 9 9 9 9 20 9 9 9 9 9 9 9 20 9 9 9 9 9 9 9 9 9 9 20
20 9 23 9 23 9 22 25 9 22 24 12 9 22 13 9 10 25 9 11 24 25 9 22 25 9 23 9 23 9 20
20 9 9 9 9 9 9 9 9 9 9 9 9 9 20 9 20 9 9 9 9 9 9 9 9 9 9 9 9 9 20
11 24 24 24 24 24 24 24 24 24 24 24 24 24 12 9 11 24 24 24 24 24 24 24 24 24 24 24 24 24 12